


1111111111111
10000000000C1
1101111011111
1P0011E000001
1111111111111



