1111111111111
10000C00000C1
110C1C0111C01
1P000CE000001
1111111111111