11111111111111111
1C000000C00000001
1000000001000W001
100P00C001000W001
1W000000010C00001
1000C000010001001
10W0000000E000W01
11111111111111111
