11111111111111111
1C000000C00000001
1010100100101W001
100000C000000W001
1W000000000C00001
1P00000C00WW01001
10W010000WE100W01
11111111111111111
