11111111111111111
1C000000C00000001
1010100100101W001
100000C000000W001
1W000000000C00001
1P00000C000W01001
10W0100000E100W01
11111111111111111
