111111111111111
1P000010000EC11
1C00CC1CCCCCC11
111111111111111